#		FLOOR		HOLE		SPINE		HEIGHT		COIN		FORCE 		GUMBA
#TIME 	SPEED	MIN	MAX	MIN	MAX	MIN	MAX	MIN	MAX	MIN	MAX	MIN	MAX	RATING
0	5	9	10	0	0	1	1	0	0	10	15	5	8	0
15	6	8	9	3	5	1	1	0	0	7	12	6	6	5
30	7	7	8	5	5	1	1	-4	4	5	10	4	3	10
45	9	5	6	5	8	1	1	1	1	2	5	3	3	15
60	8	6	7	6	8	1	1	2	2	2	4	2	2	20
