#		FLOOR		HOLE		SPINE		HEIGHT		COIN	
#TIME 	SPEED	MIN	MAX	MIN	MAX	MIN	MAX	MIN	MAX	MIN	MAX
0	5	9	10	1	2	1	1	0	0	15	10
15	6	8	9	3	5	1	1	0	0	12	7
30	7	7	8	5	5	1	1	-2	2	10	5
45	9	5	6	5	8	1	1	1	1	5	2
60	8	6	7	6	8	1	1	2	2	2	2
