#		FLOOR		HOLE		SPINE		HEIGHT		COIN	
#TIME 	SPEED	MIN	MAX	MIN	MAX	MIN	MAX	MIN	MAX	MIN	MAX
0	5	9	10	1	2	1	1	0	0	10	15 100
15	6	8	9	3	5	1	1	0	0	7	12 100
30	7	7	8	5	5	1	1	0	0	5	10 100
45	9	5	6	5	8	1	1	1	1	2	5 100
60	8	6	7	6	8	1	1	1	1	2	4 100